. . . . . . . . a a a a a a a a a a a a 
b b a b a b b . . . . . . . . . . . . . 
b l a a a l b . . . . . . . . . . . . . 
a a b b b a a . . . . . . . . . . . . . 
b a b l b a b . a . . . . . . . a . . . 
a a b b b a a . a p a e . a e . a . . . 
b l a a a l b . b b b b b b b b b . . . 
b b a b a b b . l l l l l l l l l . . . 