a b a b a b a b a b a b a b a b a b a b a b a b a b a b a b a b
l l l l l l l l l l l l l l l l l l l l l l l l l l l l l l l a
l l l l l l l l l l l l l l l l l l l l l l l l l l l l l l l a
b a b a b a b a b a b a b a b l b a b a b a b a b a b a b a b b
l l l l l l l l l l l l l l l l l l l l l l l l l l l l l l l a
l l l l l l l l l l l l l l l l l l l l l l l l l l l l l l l a
b a b a b a b a b a b a b a b l b a b a b a b a b a b a b a b b
l l l l l l l l l l l l l l l l l l l l l l l l l l l l l l l a
l l l l l l l l l l l l l l l l l l l l l l l l l l l l l l l a
b a b a b a b a b a b a b a b l b a b a b a b a b a b a b a b b
b a b a b a b a b a b a b a b l b a b a b a b a b a b a b a b a
l l l l l l l l l l l l l l l l l l l l l l l l l l l l l l l a
l l l l l l l l l l l l l l l l l l l l l l l l l l l l l l l b
b a b a b a b a b a b a b a b l b p b a b a b a b a b a b a b a
b a b a b a b a b a b a b a b l b a b a b a b a b a b a b a b a
l l l l l l l l l l l l l l l l l l l l l l l l l l l l l l l b
b a b a b a b a b a b a b a b l b a b a b a b a b a b a b a b a
l l l l l l l l l l l l l l l l l l l l l l l l l l l l l l l a
b a b a b a b a b a b a b a b l b a b a b a b a b a b a b a b b
b a b a b a b a b a b a b a b l b a b a b a b a b a b a b a b a
l l l l l l l l l l l l l l l l l l l l l l l l l l l l l l l a
a b a b a b a b a b a b a b a b a b a b a b a b a b a b a b a b