a a a a a a a a a a a a a a a 
. . . . . . . . . . . . . . . 
. . . . . . . . . . . . . . . 
. . . . . . . . . . . . . . . 
. . . a . . . . . . . a . . . 
. . . a p a e . a e . a . . . 
. . . b b b b b b b b b . . . 
. . . l l l l l l l l l . . . 